The Quad Game: Welcome to the University of Illinois
An Interactive Fiction by the Electronic Literatures & Literacies Lab
Release 1 / Serial number 241203 / Inform 7 v10.1.2 / D

The Quad Game is an Interactive Fiction sandbox created at the University of Illinois Urbana Champaign. To date it has had 100+ authors who have written 258,155 words,  creating 827 locations, 1714 things, 239 persons, and 67 narrative resolutions but no ending. Like all sandboxes, this one has bugs. New authors learn to write code by finding and fixing them, invariably leaving new bugs for future contributors to find. The Quad Game is a text-based game. What you can do will be context-specific but here are the basics: 

 LOOK (L) helps you to recall where you are.
 EXAMINE (X) things listed in descriptions and TAKE whatever you can.
 INVENTORY (I) shows you what you are carrying.
 GO north or any other cardinal direction (N, NW, NE, S, SW, SE, W, E), or up and down. 
 GO in(side), out(side), ENTER or EXIT campus buildings or enterable containers. 
 WHICH WAY (WAY) provides available directions.
 TALK TO people and ASK them ABOUT relevant topics.
 SNAPor PHOTOGRAPH things you find curious or beautiful. 
 STATUS will show your progress.
 HELP will repeat these instructions. CREDITS will give credit where credit is due. 
 Finally, SAVE your game before you QUIT or your progress will be lost!

Siebel Center for Design
You are standing outside the west entrance of the Center for Design. You can enter it from here, go north to George Huff Hall or south to Art and Design. Flagg Hall is due west, across the street.

>e
You meander about but don't really get anywhere. How about going inside?

You have noticed the summer days getting shorter and the air getting crisper. Autumn is here and the fall semester at the University of Illinois has already well begun.

>i
You are carrying:
  an icard
  basic clothes (being worn)
  your wristwatch (being worn)
  your wallet
    $25.00 in cash
  your phone

>in
West Terrace
You are standing at the west end of the Siebel Center for Design, locally known as "SCD". A support desk is in front of you, but strangely there isn't a person manning it. there are classrooms to the northwest and southwest.

>e
Gallery
You are surprised at how open this area feels and see that there are a lot of places that you can sit in. Other students are casually sitting around: working on homework, playing on their phone, or just casually resting. You feel relaxed at the sight of this.

* * *

>e
You meander about but don't really get anywhere. How about going inside?

You have noticed the summer days getting shorter and the air getting crisper. Autumn is here and the fall semester at the University of Illinois has already well begun.

>in
West Terrace
You are standing at the west end of the Siebel Center for Design, locally known as "SCD". A support desk is in front of you, but strangely there isn't a person manning it. there are classrooms to the northwest and southwest.

>e
Gallery

>e
Main Lobby
Sit (or stand if you want) at our tall tables and chairs while you work or relax in one of the captain's chairs in front of our floor-to-ceiling east windows. There are some students already sitting on the tall tables and are busy studying away.

>w
Gallery

>w
West Terrace
You are standing at the west end of the Siebel Center for Design, locally known as "SCD". A support desk is in front of you, but strangely there isn't a person manning it. there are classrooms to the northwest and southwest.

>d
Ramp

>d
End of Ramp

>d
You struggle for a while trying to make your way down, but alas it seems you won't be going that way. How about going up?

You hear a brief, but lovely set of harmonic dings, downloaded from a recording of a Tuvan throat singer, that indicates you have received a text.

>w
Lower Lobby
While not as big as the main lobby, it still has some desks and even couches for students to lounge in. A few students have already taken advantage of the two of the couches.

>n
Study hallway
Rows of white tables sit under equally white walls, which upon closer inspection, are whiteboards. The area is blindingly bright.

Your phone dings harmonically.

>e
Checkout window

>w
Study hallway
Rows of white tables sit under equally white walls, which upon closer inspection, are whiteboards. The area is blindingly bright.

>s
Lower Lobby
A small lobby for students to study in.

>u
You meander about but don't really get anywhere. How about going east?

Your phone dings harmonically.

>e
Lower Hallway
The lower counterpart of the hallway above. The northern wall is actually rows of large lockers for the Twilight residents.

>u
You try to go up but find yourself unable to do so. How about going west?

Your phone dings harmonically.

>w
Lower Lobby
A small lobby for students to study in.

>u
You try to go up but find yourself unable to do so. How about going north?

>n
Study hallway
Rows of white tables sit under equally white walls, which upon closer inspection, are whiteboards. The area is blindingly bright.

>u
You try to go up but find yourself unable to do so. How about going east?

>ne
You try to go northeast but find yourself unable to do so. How about going east?

>s
Lower Lobby
A small lobby for students to study in.

>e
Lower Hallway
The lower counterpart of the hallway above. The northern wall is actually rows of large lockers for the Twilight residents.

>w
Lower Lobby
A small lobby for students to study in.

>e
Lower Hallway
The lower counterpart of the hallway above. The northern wall is actually rows of large lockers for the Twilight residents.

* * *

>in
West Terrace
You are standing at the west end of the Siebel Center for Design, locally known as "SCD". A support desk is in front of you, but strangely there isn't a person manning it. there are classrooms to the northwest and southwest.

>nw
Classroom 1000
A typical classroom filled with desks and chairs, a computer for the teacher to use, a projection screen, and a whiteboard with barely working markers. Strangely, you notice a lonely backpack sitting on top one of the tables. Some student must have forgotten it.

>e
You try to go east but find yourself unable to do so. How about going southeast?

>se
West Terrace
You are standing at the west end of the Siebel Center for Design, locally known as "SCD". A support desk is in front of you, but strangely there isn't a person manning it. there are classrooms to the northwest and southwest.

>n
You meander about but don't really get anywhere. How about going northwest?

* * *

>in
West Terrace
You are standing at the west end of the Siebel Center for Design, locally known as "SCD". A support desk is in front of you, but strangely there isn't a person manning it. there are classrooms to the northwest and southwest.

>s
Front of elevator
In front of you is an elevator that you can use to go to the lower floors. However, there is a sign on it that says "Out of Order"

There's a small panel next to the elevator doors, but the button part is smoothed over. A keyhole sits underneath. This is weird, considering there's another normal down button on the other side.

>w
 Meeting room 1070 
 Right before you walk into the meeting room you notice that it is occupied. You decide not to be rude and let the meeting continue.

>w
You meander about but don't really get anywhere. How about going east?

>e
Front of elevator
In front of you is an elevator that you can use to go to the lower floors. However, there is a sign on it that says "Out of Order"

There's a small panel next to the elevator doors, but the button part is smoothed over. A keyhole sits underneath. This is weird, considering there's another normal down button on the other side.

>s
Front entrance
A small room with a scale model of the Siebel Center of Design. To your east is a stairwell and the north the rest of the building.

>s
South Terrace
A lesser used entrance to the Seibel Design Center. You are also not that far from the Art and Design building.

You can see Cat Plushie here.

>take plushie
you take the adorable cat plush into your inventory.

>n
Front entrance
A small room with a scale model of the Siebel Center of Design. To your east is a stairwell and the north the rest of the building.

>e
Top of Southwest Stairway

>n
You try to go north but find yourself unable to do so. How about going west?

>n
You meander about but don't really get anywhere. How about going west?

>e
You meander about but don't really get anywhere. How about going down?

>n
You try to go north but find yourself unable to do so. How about going west?

>s
You struggle for a while trying to make your way south, but alas it seems you won't be going that way. How about going west?

>w
Front entrance
A small room with a scale model of the Siebel Center of Design. To your east is a stairwell and the north the rest of the building.

>n
Front of elevator
In front of you is an elevator that you can use to go to the lower floors. However, there is a sign on it that says "Out of Order"

There's a small panel next to the elevator doors, but the button part is smoothed over. A keyhole sits underneath. This is weird, considering there's another normal down button on the other side.

>nw
You meander about but don't really get anywhere. How about going south?

>nn
I didn't understand that sentence.

>n
West Terrace
You are standing at the west end of the Siebel Center for Design, locally known as "SCD". A support desk is in front of you, but strangely there isn't a person manning it. there are classrooms to the northwest and southwest.

>n
Classroom 1002
A typical classroom filled with desks and chairs, a computer for the teacher to use, a projection screen, and a whiteboard with barely working markers.

>s
West Terrace
You are standing at the west end of the Siebel Center for Design, locally known as "SCD". A support desk is in front of you, but strangely there isn't a person manning it. there are classrooms to the northwest and southwest.

>e
Gallery
You hear a brief, but lovely set of harmonic dings, downloaded from a recording of a Tuvan throat singer, that indicates you have received a text.

>n
Main Floor Restrooms

>n
You struggle for a while trying to make your way north, but alas it seems you won't be going that way. How about going south?

>s
Gallery

>nw
Multimedia room
A digital production lab for all your storytelling needs. Record your videos and podcasts - also feel free to eat some ice cream (BYOIC).

>eat ice cream
You can't see any such thing.

>s
You try to go south but find yourself unable to do so. How about going southwest?

>se
Gallery

>n
Main Floor Restrooms

>s
Gallery

>e
Main Lobby
Sit (or stand if you want) at our tall tables and chairs while you work or relax in one of the captain's chairs in front of our floor-to-ceiling east windows. There are some students already sitting on the tall tables and are busy studying away.

>nw
Main Office
(Looks terrible) Administrators" here. Stop by to ask your questions.

You can see Teacher Plushie here.

>take plushie
(Teacher Plushie)
you take the cute plush of  teacher's into your inventory

>se
Main Lobby
Sit (or stand if you want) at our tall tables and chairs while you work or relax in one of the captain's chairs in front of our floor-to-ceiling east windows. There are some students already sitting on the tall tables and are busy studying away.

>ne
Starlight Cafe
 No starlight but more Sunlight shines through on you, you can finish your pizza here.

>sw
Main Lobby
Sit (or stand if you want) at our tall tables and chairs while you work or relax in one of the captain's chairs in front of our floor-to-ceiling east windows. There are some students already sitting on the tall tables and are busy studying away.

>se
SunriseStudio 1040

>nw
Main Lobby
Sit (or stand if you want) at our tall tables and chairs while you work or relax in one of the captain's chairs in front of our floor-to-ceiling east windows. There are some students already sitting on the tall tables and are busy studying away.

>w
Gallery

>e
Main Lobby
Sit (or stand if you want) at our tall tables and chairs while you work or relax in one of the captain's chairs in front of our floor-to-ceiling east windows. There are some students already sitting on the tall tables and are busy studying away.

You are starting to get a headache from lack of caffeine. Perhaps you should find some coffee?

>s
Top of Southeast Stairway

>w
You struggle for a while trying to make your way west, but alas it seems you won't be going that way. How about going north?

>e
You struggle for a while trying to make your way east, but alas it seems you won't be going that way. How about going northwest?

>nw
Upper Hallway

>s
SunsetStudio 1050
 Looks like there are students here working on projects together. You can see groups clearly with each cluster of students having open discussions with each other.

>n
Upper Hallway

>w
Front of elevator
In front of you is an elevator that you can use to go to the lower floors. However, there is a sign on it that says "Out of Order"

There's a small panel next to the elevator doors, but the button part is smoothed over. A keyhole sits underneath. This is weird, considering there's another normal down button on the other side.

>sw
You try to go southwest but find yourself unable to do so. How about going west?

>n
West Terrace
You are standing at the west end of the Siebel Center for Design, locally known as "SCD". A support desk is in front of you, but strangely there isn't a person manning it. there are classrooms to the northwest and southwest.

You feel your caffeine headache getting worse.

>nw
Classroom 1000
A typical classroom filled with desks and chairs, a computer for the teacher to use, a projection screen, and a whiteboard with barely working markers. Strangely, you notice a lonely backpack sitting on top one of the tables. Some student must have forgotten it.

>s
You meander about but don't really get anywhere. How about going southeast?

>ne
You try to go northeast but find yourself unable to do so. How about going southeast?

>w
You meander about but don't really get anywhere. How about going southeast?

* * *

>i
You are carrying:
  an icard
  basic clothes (being worn)
  your wristwatch (being worn)
  your wallet
    $25.00 in cash
  your phone

You have noticed the summer days getting shorter and the air getting crisper. Autumn is here and the fall semester at the University of Illinois has already well begun.

>i
You are carrying:
  an icard
  basic clothes (being worn)
  your wristwatch (being worn)
  your wallet
    $25.00 in cash
  your phone

* * *

>in
West Terrace
You are standing at the west end of the Siebel Center for Design, locally known as "SCD". A support desk is in front of you, but strangely there isn't a person manning it. there are classrooms to the northwest and southwest.

You have noticed the summer days getting shorter and the air getting crisper. Autumn is here and the fall semester at the University of Illinois has already well begun.

>e
Gallery
You are surprised at how open this area feels and see that there are a lot of places that you can sit in. Other students are casually sitting around: working on homework, playing on their phone, or just casually resting. You feel relaxed at the sight of this.

>e
Main Lobby
You look around and see tall tables and chairs to work and comfy captain's chairs in front of the floor-to-ceiling east windows. There are some students already sitting on the tall tables and are busy studying away.

A dapper man sits in one of the chairs of the Main Lobby. Draped around his neck is a sign.

>take selfie with riddler
You took a selfie with Riddler, despite sensing some reluctance. You two exchanged an awkward yet polite smile.

* * *

>n
George Huff Hall
You are standing outside George Huff Hall. You can cross the street north to the Armory or walk towards the Seibel Design Center to the south. You can also go towards the east to the Collage of Business" parking lot and continue going east to reach their building.

You have noticed the summer days getting shorter and the air getting crisper. Autumn is here and the fall semester at the University of Illinois has already well begun.

>nw
Lundgren Hall

>w
Student Dining and Residential Programs Building
The SDRP, which has 57N, the Ikenberry dining hall, and other amenities. Your one stop shop.

>i
You are carrying:
  an icard
  basic clothes (being worn)
  your wristwatch (being worn)
  your wallet
    $25.00 in cash
  your phone

>take selfie with icard
You took a selfie with the icard. Great, another 4 mb of random trash inside my head, your phone murmured.

>take selfie
You take a selfie, but you don't like how it looks so you delete it.

>e
Lundgren Hall

>n
You meander about but don't really get anywhere. How about going southeast?

>se
George Huff Hall
You are standing outside George Huff Hall. You can cross the street north to the Armory or walk towards the Seibel Design Center to the south. You can also go towards the east to the Collage of Business" parking lot and continue going east to reach their building.

>s
Siebel Center for Design
You are standing outside the west entrance of the Center for Design. You can enter it from here, go north to George Huff Hall or south to Art and Design. Flagg Hall is due west, across the street.

>in
West Terrace
You are standing at the west end of the Siebel Center for Design, locally known as "SCD". A support desk is in front of you, but strangely there isn't a person manning it. there are classrooms to the northwest and southwest.

You hear a brief, but lovely set of harmonic dings, downloaded from a recording of a Tuvan throat singer, that indicates you have received a text.

>e
Gallery
You are surprised at how open this area feels and see that there are a lot of places that you can sit in. Other students are casually sitting around: working on homework, playing on their phone, or just casually resting. You feel relaxed at the sight of this.

>e
Main Lobby
You look around and see tall tables and chairs to work and comfy captain's chairs in front of the floor-to-ceiling east windows. There are some students already sitting on the tall tables and are busy studying away.

Your phone dings harmonically.

>x riddler
You can't see any such thing.

* * *

>nw
You meander about but don't really get anywhere. How about going south?

You have noticed the summer days getting shorter and the air getting crisper. Autumn is here and the fall semester at the University of Illinois has already well begun.

>w
Flagg Hall
This building's history as a dorm is obvious from its exterior. Now it houses the studios for several different majors in the college of Art and Design. The entrance that most people use is a wheel-chair ramp on the east side of the building. The grander front doors sit unused off of the south side of the building.

Far to the east is the Architecture Building.  Inside the door in front of you is the 1st floor of Flagg Hall.

I beg your pardon?

>n
You try to go north but find yourself unable to do so. How about going south?

>nw
Weston Hall

>w
Ikenberry Commons Courtyard
You see a swath of green lawn of an awkward shape. The grass is weirdly wet. Despite this, you see people playing spikeball in the middle. You don't dare enter the grass and risk getting your socks wet.

>in
You meander about but don't really get anywhere. How about going southeast?

>n
Nugent Hall
Nugent Hall. It's the only Hall in Ikenberry that connects directly to the Student Dining and Residential Programs Building, dining hall and all. Must be nice. Surprisingly, the door is open.

>w
Wassaja Hall
You stand on the brick path, a chic frame, in front of the equally chic Wassaja Hall.

>e
Nugent Hall
Nugent Hall. It's the only Hall in Ikenberry that connects directly to the Student Dining and Residential Programs Building, dining hall and all. Must be nice. Surprisingly, the door is open.

>e
Student Dining and Residential Programs Building
The SDRP, which has 57N, the Ikenberry dining hall, and other amenities. Your one stop shop.

>in
Student Dining & Residential Programs Building Lobby
You are standing at the south entrance of the Student Dining & Residential Programs Building, or the SDRP, also called Ikenberry Commons. There is a stairwell to your east, the dining hall to your west, a study hall to your south, and 57-N to your northeast.

>e
*** Run-time problem P21: Attempt to look up a non-existent correspondence in the table 'Table of Campus Building Data'.

SDRPStairs
A tall, winding stairwell. There are some chairs and plants underneath.

* * *

>sw
You try to go southwest but find yourself unable to do so. How about going west?

You have noticed the summer days getting shorter and the air getting crisper. Autumn is here and the fall semester at the University of Illinois has already well begun.

>sw
You meander about but don't really get anywhere. How about going inside?

>sw
You try to go southwest but find yourself unable to do so. How about going north?

>w
Flagg Hall
This building's history as a dorm is obvious from its exterior. Now it houses the studios for several different majors in the college of Art and Design. The entrance that most people use is a wheel-chair ramp on the east side of the building. The grander front doors sit unused off of the south side of the building.

Far to the east is the Architecture Building.  Inside the door in front of you is the 1st floor of Flagg Hall.

>sw
You meander about but don't really get anywhere. How about going east?

>s
Taft Van Doren Hall
From here, you can go north, south or east.

>s
Irwin Indoor Football facility
You are standing in front of Irwin Indoor Football Facility at the east of the ARC. There is a truly enormous statue of a football player here. You can see Taft Van Doren Hall to the north, the ARC is to the west, and the School of Art and Design is to the northeast.

>sw
You meander about but don't really get anywhere. How about going west?

>w
Activity and Recreation Center.
You are standing outside "the ARC" at the University of Illinois at Urbana-Champaign, a multifunctional center that includes gym, classrooms for yoga, cooking, dancing and so on, swimming pool, and meeting rooms. You can go east from here.

>s
Illini Stadium
You are standing outside the Big Ten Football field where the Illini play. There's nothing happening her at the moment, and the doors are locked. You can return to the ARC to the north and to the Indoor Football Facility to the northeast.

You hear a brief, but lovely set of harmonic dings, downloaded from a recording of a Tuvan throat singer, that indicates you have received a text.

>s
You meander about but don't really get anywhere. How about going northeast?

>s
You meander about but don't really get anywhere. How about going north?

>s
You try to go south but find yourself unable to do so. How about going north?

>s
You try to go south but find yourself unable to do so. How about going northeast?

>w
You try to go west but find yourself unable to do so. How about going north?

>n
Activity and Recreation Center.
You are standing outside "the ARC" at the University of Illinois at Urbana-Champaign, a multifunctional center that includes gym, classrooms for yoga, cooking, dancing and so on, swimming pool, and meeting rooms. You can go east from here.

>w
ARC Parking Lot

>w
You try to go west but find yourself unable to do so. How about going north?

>w
You try to go west but find yourself unable to do so. How about going east?

>w
You try to go west but find yourself unable to do so. How about going north?

>w
You try to go west but find yourself unable to do so. How about going north?

>w
You struggle for a while trying to make your way west, but alas it seems you won't be going that way. How about going north?

>n
Bousfield Hall
Your phone dings harmonically.

>n
Hopkins Hall

>n
Wassaja Hall

* * *

>take selfie
You take a selfie, but you don't like how it looks so you delete it.

You have noticed the summer days getting shorter and the air getting crisper. Autumn is here and the fall semester at the University of Illinois has already well begun.

>take selfie with scd
You can't see any such thing.

>l
Siebel Center for Design
You are standing outside the west entrance of the Center for Design. You can enter it from here, go north to George Huff Hall or south to Art and Design. Flagg Hall is due west, across the street.

>in
West Terrace
You are standing at the west end of the Siebel Center for Design, locally known as "SCD". A support desk is in front of you, but strangely there isn't a person manning it. there are classrooms to the northwest and southwest.

>l
West Terrace
You are standing at the west end of the Siebel Center for Design, locally known as "SCD". A support desk is in front of you, but strangely there isn't a person manning it. there are classrooms to the northwest and southwest.

>e
Gallery
You are surprised at how open this area feels and see that there are a lot of places that you can sit in. Other students are casually sitting around: working on homework, playing on their phone, or just casually resting. You feel relaxed at the sight of this.

>e
Main Lobby
You look around and see tall tables and chairs to work and comfy captain's chairs in front of the floor-to-ceiling east windows. There are some students already sitting on the tall tables and are busy studying away.

>down
You try to go down but find yourself unable to do so. How about going south?

>s
Top of Southeast Stairway
The top of the southeast stairway. Your eyes are caught by the surrounding area.

>down
Bottom of Southeast Stairway
The bottom of the southeast stairway. Your eyes are caught by the surrounding area.

>n
You try to go north but find yourself unable to do so. How about going east?

>e
The Shop
As you open the doors, you are greeted by rows of tables covered with various devices: 3D printers, laser cutters, scanners, wood and metalworking tools, equipment lockers, and more. A few students are working on personal projects here and there, and a 3D printer whirs away in the corner on a complicated-looking project.

>x 3d printer
The printer is currently motionless, but sparkly blue filament sits on the rack in the back and feeds into the nozzle, waiting to be used.

3D Printer is currently switched off.

>take selfie with 3d printer
You can't see any such thing.

>take selfie with 3dprinter
You can't see any such thing.

>take selfie with printer
You can't see any such thing.

>flip 3d printer
You probably wouldn't be able to lift this, much less flip it.

* * *

>w
Flagg Hall
This building's history as a dorm is obvious from its exterior. Now it houses the studios for several different majors in the college of Art and Design. The entrance that most people use is a wheel-chair ramp on the east side of the building. The grander front doors sit unused off of the south side of the building.

Far to the east is the Architecture Building.  Inside the door in front of you is the 1st floor of Flagg Hall.

You have noticed the summer days getting shorter and the air getting crisper. Autumn is here and the fall semester at the University of Illinois has already well begun.

>n
You try to go north but find yourself unable to do so. How about going south?

* * *

>w
Ikenberry Commons Courtyard
You see a swath of green lawn of an awkward shape. The grass is weirdly wet. Despite this, you see people playing spikeball in the middle. You don't dare enter the grass and risk getting your socks wet.

>n
Nugent Hall
Nugent Hall. It's the only Hall in Ikenberry that connects directly to the Student Dining and Residential Programs Building, dining hall and all. Must be nice. Surprisingly, the door is open.

>e
Student Dining and Residential Programs Building
The SDRP, which has 57N, the Ikenberry dining hall, and other amenities. Your one stop shop.

* * *

>in
Student Dining & Residential Programs Building Lobby
You are standing at the south entrance of the Student Dining & Residential Programs Building, or the SDRP, also called Ikenberry Commons. There is a stairwell to your east, the dining hall to your west, a study hall to your south, and 57-N to your northeast.

>n
You try to go north but find yourself unable to do so. How about going south?

>ne
57 North
It's closed... you see someone mopping inside. Wonder what happened.

>in
You try to go inside but find yourself unable to do so. How about going southwest?

>w
You try to go west but find yourself unable to do so. How about going southwest?

>se
You meander about but don't really get anywhere. How about going southwest?

>way
You may go southwest.

>sw
Student Dining & Residential Programs Building Lobby
You are standing at the south entrance of the Student Dining & Residential Programs Building, or the SDRP, also called Ikenberry Commons. There is a stairwell to your east, the dining hall to your west, a study hall to your south, and 57-N to your northeast.

>s
SDRP Study.
A large, almost liminal, study room. People are working away at some computers, though one is empty.

>l
SDRP Study.
A large, almost liminal, study room. People are working away at some computers, though one is empty.

>x computer
You can't see any such thing.

>x sdrpcomputer
A game is open. Looks like an escape room.

>play escape room
You sit down in front of the computer and look at the screen.

Baby's First Escape Room Game
This looks to be a very bare bones escape room. You see nine switches, a riddle, and a hint sheet.

>x riddle
You see nothing special about Riddle.

>read riddle
To escape this prison, you must find the gods to bring peace and harmony. Choose wisely, for only three will reveal the path.

>read hint
Hint: communication, love, and hospitality are your ingredients.

>x switches
You can't see any such thing.

>switch mercury
You turn on the Mercury switch.

>switch venus
You turn on the Venus switch.

>switch mars
You turn on the Mars switch.

>switch jupiter
You turn on the Jupiter switch.
You hear a click, and you get a congratulations!

SDRP Study.
A large, almost liminal, study room. People are working away at some computers, though one is empty.

>play escape room
You already beat it.

>n
Student Dining & Residential Programs Building Lobby
You are standing at the south entrance of the Student Dining & Residential Programs Building, or the SDRP, also called Ikenberry Commons. There is a stairwell to your east, the dining hall to your west, a study hall to your south, and 57-N to your northeast.

>e
SDRP Stairs.
A tall, winding stairwell. There are some chairs and plants underneath.

>up
Student Dining & Residential Programs Building Lobby upper floor
The upper floor of the SDRP. To your south is the Ikenberry library and the north Caffinator. You can always go back down, too.

>w
You try to go west but find yourself unable to do so. How about going north?

You hear a brief, but lovely set of harmonic dings, downloaded from a recording of a Tuvan throat singer, that indicates you have received a text.

>n
Caffinator
The caffinator is one of the many UIUC dining locations, meaning it accepts dining dollars and Illini-Bucks. Other than that, it's like most other middling coffee places.

You can see a Caffmenu here.

>x menu
You can't see any such thing.

>x caffmenu
Drinks
Drip Coffee - $2.75
Espresso -$2.25
Chai Latte - $5.00
Hot Tea - $2.70
Hot Cocoa - $3.90.

>buy coffee
Which do you mean, the Drip Coffee or the Drip Coffee?

>buy drip coffee
Which do you mean, the Drip Coffee or the Drip Coffee?

>buy tea
You pay $2.70 for the Hot Tea, leaving yourself with $22.30.

>drink tea
You sip your drink. Definitely worth the price!

>buy chai
You pay $5.00 for the Chai Latte, leaving yourself with $17.30.

>x chai
Warm milk on hot water and chai syrup. You know several people who would be very dissapointed if they learned you have this.

>drink chai
You sip your drink. Definitely worth the price!

* * *

>nw
Weston Hall

>sw
You try to go southwest but find yourself unable to do so. How about going southeast?

>se
Flagg Hall
This building's history as a dorm is obvious from its exterior. Now it houses the studios for several different majors in the college of Art and Design. The entrance that most people use is a wheel-chair ramp on the east side of the building. The grander front doors sit unused off of the south side of the building.

Far to the east is the Architecture Building.  Inside the door in front of you is the 1st floor of Flagg Hall.

>w
No one uses the main entrance. Not only is it further away, its actually the furthest entrance from where most people want to be.

>n
You try to go north but find yourself unable to do so. How about going east?

>e
Siebel Center for Design
You are standing outside the west entrance of the Center for Design. You can enter it from here, go north to George Huff Hall or south to Art and Design. Flagg Hall is due west, across the street.

>n
George Huff Hall
You are standing outside George Huff Hall. You can cross the street north to the Armory or walk towards the Seibel Design Center to the south. You can also go towards the east to the Collage of Business" parking lot and continue going east to reach their building.

>w
You try to go west but find yourself unable to do so. How about going northwest?

>nw
Lundgren Hall

* * *

>w
Student Dining and Residential Programs Building
The SDRP, which has 57N, the Ikenberry dining hall, and other amenities. Your one stop shop.

>in
SDRPInterior
You are standing at the south entrance of the Student Dining & Residential Programs Building, or the SDRP. There is a stairwell to your east, the dining hall to your west, and 57-N to your northeast.

* * *

>w
No one uses the main entrance. Not only is it further away, its actually the furthest entrance from where most people want to be.

>n
You meander about but don't really get anywhere. How about going east?

>e
Siebel Center for Design
You are standing outside the west entrance of the Center for Design. You can enter it from here, go north to George Huff Hall or south to Art and Design. Flagg Hall is due west, across the street.

* * *

>n
George Huff Hall
You are standing outside George Huff Hall. You can cross the street north to the Armory or walk towards the Seibel Design Center to the south. You can also go towards the east to the Collage of Business" parking lot and continue going east to reach their building.

>w
You meander about but don't really get anywhere. How about going northwest?

>way
You may go north, northwest, south, and east.

>nw
Lundgren Hall

>w
Student Dining and Residential Programs Building

>in
You try to go inside but find yourself unable to do so. How about going south?

>i
You are carrying:
  an icard
  basic clothes (being worn)
  your wristwatch (being worn)
  your wallet
    $25.00 in cash
  your phone